5
vermelho assets/imagens/r.png 1
Tile assets/imagens/0x72_16x16DungeonTileset.v4.png 16
grama	 assets/imagens/g.png 1
agua	 assets/imagens/b.png 1
Tile2 assets/imagens/0x72_16x16DungeonTileset_walls.v2.png 16



3 32 24

101 101 101 101 101 101 101 101 101 101 101 101 101 101 101 101 101 101 101 101 101 101 101 101 101 101 101 101 101 101 101 101 
101 101 101 101 101 101 101 101 101 101 101 101 101 101 101 101 101 101 101 101 101 101 101 101 101 101 101 101 101 101 101 101 
101 101 101 101 101 101 101 101 101 101 101 101 101 101 101 101 101 101 101 101 101 101 101 101 101 101 101 101 101 101 101 101 
101 101 101 63 63 63 101 63 101 63 101 63 101 101 63 63 63 63 101 101 101 101 101 101 101 101 101 101 101 101 101 101 
101 101 101 63 63 63 63 63 63 63 63 63 63 63 63 63 63 63 101 101 101 101 101 101 101 101 101 101 101 101 101 101 
101 101 101 63 63 63 63 63 63 63 63 63 63 63 63 63 63 63 101 101 101 101 101 101 101 101 101 101 101 101 101 101 
101 101 101 63 63 63 63 63 63 63 63 63 63 63 63 63 63 63 101 101 101 101 101 101 101 101 101 101 101 101 101 101 
101 101 101 63 63 63 63 63 63 63 63 63 63 63 63 63 63 63 101 101 101 101 101 101 101 101 101 101 101 101 101 101 
101 101 101 101 101 101 101 101 101 101 101 63 63 101 101 101 101 101 101 101 101 101 101 101 101 101 101 101 101 101 101 101 
101 101 101 101 101 101 101 101 101 101 101 63 63 101 101 101 101 101 101 101 101 101 101 101 101 101 101 101 101 101 101 101 
101 101 101 101 101 101 101 101 101 101 101 63 63 101 101 101 101 101 101 101 101 101 101 101 101 101 101 101 101 101 101 101 
101 101 101 101 101 101 101 101 101 101 101 63 63 101 101 101 101 101 101 101 101 101 101 101 101 101 101 101 101 101 101 101 
101 101 101 101 101 101 101 101 101 101 101 63 63 101 101 101 101 101 101 101 101 101 101 101 101 101 101 101 101 101 101 101 
101 101 101 101 101 101 101 101 101 101 63 63 63 63 101 101 101 101 101 101 101 101 101 101 101 101 101 101 101 101 101 101 
101 101 101 101 101 101 101 101 101 101 63 63 63 63 63 63 63 63 63 63 63 63 63 63 101 101 101 101 101 101 101 101 
101 101 101 101 101 63 63 101 63 63 63 63 63 63 63 63 63 63 63 63 63 63 63 101 101 101 101 101 101 101 101 101 
101 101 101 101 101 63 63 63 63 63 63 63 63 63 63 63 63 63 63 63 63 63 63 63 63 101 101 101 101 101 101 101 
101 101 101 101 101 63 63 63 63 63 63 63 63 63 63 63 63 101 101 101 101 101 101 101 101 101 101 101 101 101 101 101 
101 101 101 101 101 63 63 63 63 63 63 63 63 63 63 63 63 101 101 101 101 101 101 101 101 101 101 101 101 101 101 101 
101 101 101 101 101 63 63 63 63 63 63 63 63 63 63 63 63 101 101 101 101 101 101 101 101 101 101 101 101 101 101 101 
101 101 101 101 101 63 63 63 63 63 63 63 63 63 63 63 63 101 101 101 101 101 101 101 101 101 101 101 101 101 101 101 
101 101 101 101 101 101 101 101 101 101 101 101 101 63 63 63 63 101 101 101 101 101 101 101 101 101 101 101 101 101 101 101 
101 101 101 101 101 101 101 101 101 101 101 101 101 63 63 63 63 101 101 101 101 101 101 101 101 101 101 101 101 101 101 101 
101 101 101 101 101 101 101 101 101 101 101 101 101 101 101 101 101 101 101 101 101 101 101 101 101 101 101 101 101 101 101 101

101 101 101 101 101 101 101 101 101 101 101 101 101 101 101 101 101 101 101 101 101 101 101 101 101 101 101 101 101 101 101 101 
101 101 101 101 101 101 101 101 101 101 101 101 101 101 101 101 101 101 101 101 101 101 101 101 101 101 101 101 101 101 101 101 
101 51 18 101 19 101 101 101 18 19 101 101 18 101 101 19 101 101 19 19 101 101 101 101 101 101 101 101 101 101 101 101 
101 51 34 34 34 34 34 34 34 34 34 34 34 34 34 34 34 34 51 51 101 101 101 101 101 101 101 101 101 101 101 101 
101 51 51 97 98 99 100 101 101 51 101 101 101 101 101 101 51 101 51 51 101 101 101 101 101 101 101 101 101 101 101 101 
101 51 51 113 114 115 116 101 101 101 101 101 101 101 101 101 101 101 51 51 101 101 101 101 101 101 101 101 101 101 101 101 
101 51 51 129 130 131 132 101 101 101 101 101 101 101 101 101 101 101 51 51 101 101 101 101 101 101 101 101 101 101 101 101 
101 51 51 101 101 101 101 101 101 101 101 22 23 101 101 101 101 101 51 51 101 101 101 101 101 101 101 101 101 101 101 101 
101 101 101 101 101 101 101 101 101 101 101 38 39 101 101 101 101 101 101 101 101 101 101 101 101 101 101 101 101 101 101 101 
101 101 101 101 101 101 101 101 101 51 51 22 23 51 51 101 101 101 101 101 101 101 101 101 101 101 101 101 101 101 101 101 
101 101 101 101 101 101 101 101 101 51 51 38 39 51 51 101 101 101 101 101 101 101 101 101 101 101 101 101 101 101 101 101 
101 101 101 101 101 101 101 101 101 51 51 101 101 51 51 101 101 101 101 101 101 101 101 101 101 101 101 101 101 101 101 101 
101 101 101 101 101 71 101 101 101 51 101 101 101 51 51 101 101 101 101 101 101 101 101 101 101 101 51 51 101 101 101 101 
101 101 101 101 101 87 101 101 101 101 101 101 101 51 51 101 101 101 101 101 101 101 101 101 101 82 51 51 101 101 101 101 
101 101 101 101 101 51 51 101 51 51 101 101 101 101 101 101 101 101 101 101 101 101 101 101 51 51 51 51 101 101 101 101 
101 101 101 101 101 101 101 51 101 101 101 101 101 101 101 101 101 101 101 101 101 101 101 51 51 51 51 51 101 101 101 101 
101 101 101 101 101 101 101 101 101 101 101 101 101 101 101 101 101 101 101 101 101 101 101 101 101 51 51 51 101 101 101 101 
101 17 18 19 19 101 101 101 101 101 101 101 101 101 101 101 101 51 51 101 101 101 101 101 101 101 101 101 101 101 101 101 
101 51 51 103 51 101 101 101 101 101 101 101 101 101 101 101 101 51 51 101 101 101 101 101 101 101 101 101 101 101 101 101 
101 51 51 119 51 101 101 101 101 101 101 101 101 101 101 101 101 51 51 101 101 101 101 101 101 101 101 101 101 101 101 101 
101 51 51 119 118 101 101 101 101 101 101 101 101 101 101 101 101 51 51 101 101 101 101 101 101 101 101 101 101 101 101 101 
101 101 101 101 101 101 101 101 101 101 101 51 51 101 101 101 101 51 51 101 101 101 101 101 101 101 101 101 101 101 101 101 
101 101 101 101 101 101 101 101 101 101 101 51 51 101 101 101 101 51 51 101 101 101 101 101 101 101 101 101 101 101 101 101 
101 101 101 101 101 101 101 101 101 101 101 101 101 101 101 101 101 101 101 101 101 101 101 101 101 101 101 101 101 101 101 101 

101 101 101 101 101 101 101 101 101 101 101 101 101 101 101 101 101 101 101 101 101 101 101 101 101 101 244 244 245 245 245 245 
101 123 1 1 1 1 1 1 1 1 1 1 1 1 1 1 1 2 125 126 101 101 101 101 101 101 244 244 245 245 245 245 
101 139 124 17 50 17 103 17 153 50 17 17 153 103 17 50 17 18 125 126 101 101 101 101 101 101 244 244 245 245 245 245 
101 123 124 34 34 34 119 34 169 34 150 34 169 119 34 34 34 34 125 126 101 101 101 101 101 101 244 244 245 245 245 245 
101 123 124 51 51 51 51 51 51 51 51 51 51 51 51 51 51 51 125 126 101 101 101 101 101 101 244 244 245 245 245 245 
101 123 124 51 97 98 99 100 51 51 51 51 51 51 51 51 51 51 125 126 101 101 101 101 101 101 244 244 245 245 245 245 
101 123 124 51 113 114 115 116 51 51 51 51 51 51 51 51 51 51 125 126 101 101 101 101 101 101 244 245 245 245 245 245 
101 139 140 51 129 130 131 132 51 51 51 22 23 51 51 51 51 51 141 142 101 101 101 101 101 101 244 245 245 245 245 245 
101 101 101 25 25 25 25 25 25 25 25 38 39 9 9 9 9 9 9 101 101 101 101 101 101 101 244 245 245 245 245 245 
101 101 101 101 101 101 101 101 101 123 124 51 51 125 126 101 101 101 101 101 101 101 101 101 101 101 244 245 245 245 245 245 
101 101 101 101 101 101 101 101 101 123 124 51 51 125 126 101 101 101 101 101 101 101 101 101 101 101 244 245 244 245 245 245 
101 101 101 101 101 55 49 49 49 103 140 51 51 141 103 49 49 49 49 49 49 49 49 49 49 49 125 126 244 245 245 245 
101 101 101 101 101 71 65 65 65 119 118 51 51 118 119 67 67 67 66 66 66 66 66 66 66 66 141 142 244 245 245 245 
101 101 101 101 101 87 81 81 81 118 51 51 51 51 118 83 83 83 82 82 82 82 82 82 82 50 141 142 244 245 245 245 
101 101 101 101 101 223 223 51 223 223 51 51 51 51 51 51 51 51 51 51 97 98 99 100 183 184 50 142 244 245 245 245 
101 101 101 101 101 51 97 232 99 100 51 51 51 51 51 51 51 51 51 51 113 114 115 161 199 200 50 126 244 245 245 245 
101 1 1 2 3 51 113 114 115 116 51 51 51 51 51 51 51 51 51 51 129 130 131 132 51 50 141 142 244 245 245 245 
245 123 124 18 19 51 129 130 131 132 51 51 51 51 51 51 51 125 126 9 9 9 9 9 9 9 9 245 244 245 245 245 
245 139 140 189 234 51 51 51 51 51 51 51 51 51 51 51 51 125 126 244 244 244 244 244 244 244 244 245 244 245 245 245 
245 123 124 103 102 51 51 51 51 51 51 51 51 97 98 99 100 125 126 245 245 245 244 244 244 244 244 245 245 245 245 245 
245 139 140 119 118 51 51 51 51 51 51 51 51 113 114 115 116 141 142 245 245 245 245 245 245 245 245 245 245 245 245 245 
245 245 24 24 24 24 24 24 24 24 25 123 124 129 130 131 132 125 126 245 245 245 245 245 245 245 245 245 245 245 245 245 
245 245 245 245 245 245 245 245 245 245 245 139 140 51 51 51 51 141 142 245 245 245 245 245 245 245 245 245 245 245 245 245 
245 245 245 245 245 245 245 245 245 245 245 245 24 24 24 24 24 25 245 245 245 245 245 245 245 245 245 245 245 245 245 245