5
vermelho assets/imagens/r.png 1
Tile assets/imagens/0x72_16x16DungeonTileset_walls.v2.png 24
grama	 assets/imagens/g.png 1
agua	 assets/imagens/b.png 1
Tile2 assets/imagens/0x72_16x16DungeonTileset.v4.png 16



3 32 24

101 101 101 101 101 101 101 101 101 101 101 101 101 101 101 101 101 101 101 101 101 101 101 101 101 101 101 101 101 101 101 101 
101 101 101 101 101 101 101 101 101 101 101 101 101 101 101 101 101 101 101 101 101 101 101 101 101 101 101 101 101 101 101 101 
101 101 101 101 101 101 101 101 101 101 101 101 101 101 101 101 101 101 101 101 101 101 101 101 101 101 101 101 101 101 101 101 
101 101 101 101 101 101 101 101 101 101 101 101 101 101 101 101 101 101 101 101 101 101 101 101 101 101 101 101 101 101 101 101 
101 101 101 101 101 101 101 101 101 101 101 101 101 63 63 63 63 63 63 101 101 101 101 101 101 101 101 101 101 101 101 101 
101 101 101 101 101 101 101 101 101 101 101 101 101 63 101 63 63 63 63 63 63 101 101 101 101 101 101 101 101 101 101 101 
101 101 101 101 101 101 101 101 101 101 101 101 101 63 101 63 63 63 63 63 63 63 101 101 101 101 101 101 101 101 101 101 
101 101 101 101 101 101 101 101 101 101 101 101 101 63 101 101 101 63 63 63 63 63 101 101 101 101 101 101 101 101 101 101 
101 101 101 101 101 101 101 101 101 101 101 101 101 63 63 63 63 101 63 63 63 63 101 101 101 101 101 101 101 101 101 101 
101 101 101 101 101 101 101 101 101 101 101 101 101 101 101 101 63 101 63 63 63 101 101 101 101 101 101 101 101 101 101 101 
101 101 101 101 101 101 101 101 101 101 101 101 101 101 101 101 63 101 63 63 63 101 101 101 101 101 101 101 101 101 101 101 
101 101 101 101 101 101 101 101 101 101 101 101 101 101 101 101 63 101 63 63 63 101 101 101 101 101 101 101 101 101 101 101 
101 101 101 101 101 101 101 101 101 101 101 101 101 101 101 101 63 101 63 63 63 101 101 101 101 101 101 101 101 101 101 101 
101 101 101 101 101 101 101 101 101 101 101 101 101 101 101 101 63 101 101 101 101 101 101 101 101 101 101 101 101 101 101 101 
101 101 101 101 101 101 101 101 101 101 101 101 101 101 101 101 63 101 101 101 101 101 101 101 101 101 101 101 101 101 101 101 
101 101 101 101 101 101 101 101 101 101 101 101 101 101 101 63 63 101 101 101 101 101 101 101 101 101 101 101 101 101 101 101 
101 101 101 101 101 101 101 101 101 101 101 101 101 101 101 63 63 101 101 101 101 101 101 101 101 101 101 101 101 101 101 101 
101 101 101 101 101 101 101 101 101 101 101 101 101 101 101 63 63 101 101 101 101 101 101 101 101 101 101 101 101 101 101 101 
101 101 101 101 101 101 101 101 101 101 101 101 63 63 63 63 63 63 63 63 101 101 101 101 101 101 101 101 101 101 101 101 
101 101 101 101 101 101 101 101 101 101 101 101 63 63 63 63 63 63 63 63 101 101 101 101 101 101 101 101 101 101 101 101 
101 101 101 101 101 101 101 101 101 101 101 101 63 63 63 63 63 63 63 63 101 101 101 101 101 101 101 101 101 101 101 101 
101 101 101 101 101 101 101 101 101 101 101 101 51 51 51 63 51 63 51 51 51 101 101 101 101 101 101 101 101 101 101 101 
101 101 101 101 101 101 101 101 101 101 101 101 51 51 51 51 51 51 51 51 101 101 101 101 101 101 101 101 101 101 101 101 
101 101 101 101 101 101 101 101 101 101 101 101 51 51 51 51 51 51 51 51 101 101 101 101 101 101 101 101 101 101 101 101

101 101 101 101 101 101 101 101 101 101 101 101 101 101 101 101 101 101 101 101 101 101 101 101 101 101 101 101 101 101 101 101 
101 101 101 101 101 101 101 101 101 101 1 1 1 1 1 1 1 1 1 1 2 3 101 101 101 101 101 101 101 101 101 101 
101 101 101 101 101 101 101 101 101 101 17 17 17 17 17 17 17 17 17 17 18 19 101 101 101 101 101 101 101 101 101 101 
101 101 101 101 101 101 101 101 101 101 33 33 33 33 33 33 33 33 33 33 34 35 101 101 101 101 101 101 101 101 101 101 
101 101 101 101 101 101 101 101 101 51 51 51 51 51 51 51 51 101 101 51 101 51 51 101 101 101 101 101 101 101 101 101 
101 101 101 101 101 101 101 101 101 51 51 51 51 51 51 101 101 101 101 101 101 51 51 101 101 101 101 101 101 101 101 101 
101 101 101 101 101 101 101 101 101 51 51 51 51 51 51 51 51 51 51 51 51 51 51 101 101 101 101 101 101 101 101 101 
101 101 101 101 101 101 101 101 101 51 51 51 51 51 51 51 51 51 51 51 51 51 51 101 101 101 101 101 101 101 101 101 
101 101 101 101 101 101 101 101 101 51 33 34 51 71 51 51 168 51 51 101 101 51 51 101 101 101 101 101 101 101 101 101 
101 101 101 101 101 101 101 101 101 51 51 51 168 51 51 51 168 51 51 101 101 51 51 101 101 101 101 101 101 101 101 101 
101 101 101 101 101 101 101 101 101 51 101 51 168 51 51 51 101 51 101 101 101 51 51 101 101 101 101 101 101 101 101 101 
101 101 101 101 101 101 101 101 101 51 51 51 51 51 51 51 101 51 51 51 51 51 51 101 101 101 101 101 101 101 101 101 
101 101 101 101 101 101 101 101 101 51 51 51 51 51 51 51 101 51 51 51 51 51 51 101 101 101 101 101 101 101 101 101 
101 101 101 101 101 101 101 101 101 51 51 51 51 51 51 51 101 51 51 51 51 51 51 101 101 101 101 101 101 101 101 101 
101 101 101 101 101 101 101 101 101 101 101 101 101 101 51 119 101 51 101 101 101 101 101 101 101 101 101 101 101 101 101 101 
101 101 101 101 101 101 101 101 101 101 101 101 101 101 101 101 101 101 101 101 101 101 101 101 101 101 101 101 101 101 101 101 
101 101 101 101 101 101 101 101 101 101 101 101 101 101 101 22 23 101 101 101 101 101 101 101 101 101 101 101 101 101 101 101 
101 101 101 101 101 101 101 101 101 101 101 101 101 101 101 38 39 101 101 101 101 101 101 101 101 101 101 101 101 101 101 101 
101 101 101 101 101 101 101 101 101 101 51 51 101 101 101 101 101 101 101 101 51 51 101 101 101 101 101 101 101 101 101 101 
101 101 101 101 101 101 101 101 101 101 51 51 101 101 101 101 101 101 101 101 51 51 101 101 101 101 101 101 101 101 101 101 
101 101 101 101 101 101 101 101 101 101 51 51 101 51 51 101 101 51 51 51 51 51 101 101 101 101 101 101 101 101 101 101 
101 101 101 101 101 101 101 101 101 101 51 51 101 51 51 101 51 101 51 51 51 51 101 101 101 101 101 101 101 101 101 101 
101 101 101 101 101 101 101 101 101 101 51 51 101 51 51 51 182 51 51 101 51 51 101 101 101 101 101 101 101 101 101 101 
101 101 101 101 101 101 101 101 101 101 51 51 101 51 101 51 51 51 101 101 51 51 101 101 101 101 101 101 101 101 101 101

101 101 101 101 101 101 101 101 101 101 101 101 101 101 101 101 101 101 101 101 101 101 101 101 101 101 101 101 101 101 101 101 
101 101 101 101 101 101 101 101 101 101 1 1 1 1 1 1 1 1 1 1 2 3 101 101 101 101 101 101 101 101 101 101 
101 101 101 101 101 101 101 101 101 101 17 17 17 17 17 17 17 17 17 17 18 19 101 101 101 101 101 101 101 101 101 101 
101 101 101 101 101 101 101 101 101 101 33 33 103 103 103 33 33 33 33 33 34 35 101 101 101 101 101 101 101 101 101 101 
101 101 101 101 101 101 101 101 101 123 124 51 119 119 119 51 51 51 51 51 51 125 126 125 126 101 101 101 101 101 101 101 
101 101 101 101 101 101 101 101 101 139 140 51 168 162 168 51 51 51 51 51 51 141 142 141 142 101 101 101 101 101 101 101 
101 101 101 101 101 101 101 101 101 123 51 51 168 51 168 51 51 51 51 51 51 51 126 125 126 101 101 101 101 101 101 101 
101 101 101 101 101 101 101 101 101 139 51 51 168 51 168 168 168 51 51 51 51 51 142 141 142 101 101 101 101 101 101 101 
101 101 101 101 101 101 101 101 101 123 51 51 168 51 51 51 51 168 51 51 51 51 126 125 126 101 101 101 101 101 101 101 
101 101 101 101 101 101 101 101 101 139 140 51 51 168 168 50 51 168 51 51 51 141 142 141 142 101 101 101 101 101 101 101 
101 101 101 101 101 101 101 101 101 123 51 51 51 51 168 51 51 168 51 51 51 125 126 125 126 101 101 101 101 101 101 101 
101 101 101 101 101 101 101 101 101 123 124 51 51 51 168 50 51 168 51 51 51 125 126 125 126 101 101 101 101 101 101 101 
101 101 101 101 101 101 101 101 101 139 140 51 51 51 168 51 51 168 51 51 51 141 142 141 142 101 101 101 101 101 101 101 
55 1 2 1 2 3 55 75 76 75 76 75 76 55 168 50 51 168 55 75 76 75 76 75 76 55 1 2 1 2 3 55 
71 17 18 17 18 19 71 91 92 91 92 91 92 71 168 51 51 168 71 91 92 91 92 91 92 71 17 18 17 18 19 71 
87 33 34 33 34 35 87 107 108 107 108 107 108 87 33 34 35 33 87 107 108 107 108 107 108 87 33 34 33 34 35 87 
101 101 101 101 101 101 101 101 101 101 101 101 101 101 101 22 23 101 101 101 101 101 101 101 101 101 101 101 101 101 101 101 
101 101 101 101 101 101 101 101 101 101 101 101 101 101 101 38 39 101 101 101 101 101 101 101 101 101 101 101 101 101 101 101 
101 101 101 101 101 101 101 101 101 101 123 124 51 51 97 98 99 100 51 51 125 126 101 101 101 101 101 101 101 101 101 101 
101 101 101 101 101 101 101 101 101 101 139 140 51 51 113 114 115 116 51 51 141 142 101 101 101 101 101 101 101 101 101 101 
101 101 101 101 101 101 101 101 101 101 123 124 51 153 154 130 131 132 153 154 125 126 101 101 101 101 101 101 101 101 101 101 
101 101 101 101 101 101 101 101 101 101 139 140 51 169 170 51 182 51 169 170 141 142 101 101 101 101 101 101 101 101 101 101 
101 101 101 101 101 101 101 101 101 101 123 124 51 51 51 51 51 51 51 51 125 126 101 101 101 101 101 101 101 101 101 101 
101 101 101 101 101 101 101 101 101 101 139 140 51 51 51 51 51 51 51 51 141 142 101 101 101 101 101 101 101 101 101 101

